"","date","doses","dosescm","fdoses","fdosescm","sdoses","sdosescm","pop","doses7d","dosert","fdoses7d","fdosert","sdoses7d","sdosert"
"1",2020-12-16,14,14,14,14,0,0,110029,0,0.0127239182397368,0,0.0127239182397368,0,0
"2",2020-12-17,154,168,154,168,0,0,110029,0,0.152687018876842,0,0.152687018876842,0,0
"3",2020-12-18,1982,2150,1982,2150,0,0,110029,0,1.95403030110244,0,1.95403030110244,0,0
"4",2020-12-19,5714,7864,5714,7864,0,0,110029,0,7.14720664552073,0,7.14720664552073,0,0
"5",2020-12-20,3430,11294,3430,11294,0,0,110029,0,10.2645666142562,0,10.2645666142562,0,0
"6",2020-12-21,932,12226,932,12226,0,0,110029,0,11.1116160285016,0,11.1116160285016,0,0
"7",2020-12-22,4367,16593,4367,16593,0,0,110029,2370.42857142857,15.0805696679966,2370.42857142857,15.0805696679966,0,0
"8",2020-12-23,3640,20233,3640,20233,0,0,110029,2888.42857142857,18.3887884103282,2888.42857142857,18.3887884103282,0,0
"9",2020-12-24,2777,23010,2777,23010,0,0,110029,3263.14285714286,20.9126684783103,3263.14285714286,20.9126684783103,0,0
"10",2020-12-25,963,23973,963,23973,0,0,110029,3117.57142857143,21.7878922829436,3117.57142857143,21.7878922829436,0,0
"11",2020-12-26,3,23976,3,23976,0,0,110029,2301.71428571429,21.7906188368521,2301.71428571429,21.7906188368521,0,0
"12",2020-12-27,479,24455,479,24455,0,0,110029,1880.14285714286,22.2259586109117,1880.14285714286,22.2259586109117,0,0
"13",2020-12-28,10,24465,10,24465,0,0,110029,1748.42857142857,22.2350471239401,1748.42857142857,22.2350471239401,0,0
"14",2020-12-29,2296,26761,2296,26761,0,0,110029,1452.57142857143,24.3217697152569,1452.57142857143,24.3217697152569,0,0
"15",2020-12-30,3985,30746,3985,30746,0,0,110029,1501.85714285714,27.9435421570677,1501.85714285714,27.9435421570677,0,0
"16",2020-12-31,4930,35676,4930,35676,0,0,110029,1809.42857142857,32.4241790800607,1809.42857142857,32.4241790800607,0,0
"17",2021-01-01,1968,37644,1968,37644,0,0,110029,1953,34.2127984440466,1953,34.2127984440466,0,0
"18",2021-01-02,160,37804,160,37804,0,0,110029,1975.42857142857,34.3582146525007,1975.42857142857,34.3582146525007,0,0
"19",2021-01-03,1474,39278,1474,39278,0,0,110029,2117.57142857143,35.6978614728844,2117.57142857143,35.6978614728844,0,0
"20",2021-01-04,1103,40381,1076,40354,27,27,110029,2273.71428571429,36.7003244599151,2269.85714285714,36.6757854747385,3.85714285714286,0.0245389851766352
"21",2021-01-05,3612,43993,3410,43764,202,229,110029,2461.71428571429,39.9830953657672,2429,39.7749684174172,32.7142857142857,0.20812694834998
"22",2021-01-06,4526,48519,4268,48032,258,487,110029,2539,44.0965563624135,2469.42857142857,43.6539457779313,69.5714285714286,0.442610584482273
"23",2021-01-07,3905,52424,3184,51216,721,1208,110029,2392.57142857143,47.6456206999973,2220,46.5477283261686,172.571428571429,1.09789237382872
"24",2021-01-08,5939,58363,2857,54073,3082,4290,110029,2959.85714285714,53.0432885875542,2347,49.1443164983777,612.857142857143,3.89897208917649
"25",2021-01-09,8856,67219,3683,57756,5173,9463,110029,4202.14285714286,61.0920757254906,2850.28571428571,52.4916158467313,1351.85714285714,8.60045987875924
"26",2021-01-10,4137,71356,1421,59177,2716,12179,110029,4582.57142857143,64.8519935653328,2842.71428571429,53.7830935480646,1739.85714285714,11.0689000172682
"27",2021-01-11,1413,72769,634,59811,779,12958,110029,4626.85714285714,66.1362004562434,2779.57142857143,54.3593052740641,1847.28571428571,11.7768951821792
"28",2021-01-12,5742,78511,2019,61830,3723,16681,110029,4931.14285714286,71.3548246371411,2580.85714285714,56.1942760544947,2350.28571428571,15.1605485826464
"29",2021-01-13,6773,85284,3725,65555,3048,19729,110029,5252.14285714286,77.5104745112652,2503.28571428571,59.5797471575676,2748.85714285714,17.9307273536977
"30",2021-01-14,6631,91915,4236,69791,2395,22124,110029,5641.57142857143,83.5370675003863,2653.57142857143,63.4296412763908,2988,20.1074262239955
"31",2021-01-15,4736,96651,3903,73694,833,22957,110029,5469.71428571429,87.8413872706287,2803,66.9768879113688,2666.71428571429,20.8644993592598
"32",2021-01-16,4300,100951,3819,77513,481,23438,110029,4818.85714285714,91.7494478728335,2822.42857142857,70.4477910369084,1996.42857142857,21.3016568359251
"33",2021-01-17,3061,104012,2559,80072,502,23940,110029,4665.14285714286,94.5314417108217,2985,72.7735415208718,1680.14285714286,21.7579001899499
"34",2021-01-18,1281,105293,853,80925,428,24368,110029,4646.28571428571,95.6956802297576,3016.28571428571,73.5487916821929,1630,22.1468885475647
"35",2021-01-19,4370,109663,2878,83803,1492,25860,110029,4450.28571428571,99.6673604231612,3139,76.1644657317616,1311.28571428571,23.5028946913995
"36",2021-01-20,5978,115641,3690,87493,2288,28148,110029,4336.71428571429,105.100473511529,3134,79.5181270392351,1202.71428571429,25.5823464722937
"37",2021-01-21,8085,123726,5381,92874,2704,30852,110029,4544.42857142857,112.448536294977,3297.57142857143,84.4086558998082,1246.85714285714,28.0398803951685
"38",2021-01-22,10424,134150,8628,101502,1796,32648,110029,5357,121.922402275764,3972.57142857143,92.2502249406974,1384.42857142857,29.6721773350662
"39",2021-01-23,9622,143772,8668,110170,954,33602,110029,6117.28571428571,130.667369511674,4665.28571428571,100.1281480337,1452,30.539221477974
"40",2021-01-24,4930,148702,4366,114536,564,34166,110029,6384.28571428571,135.148006434667,4923.42857142857,104.096192821892,1460.85714285714,31.0518136127748
"41",2021-01-25,1721,150423,1595,116131,126,34292,110029,6447.14285714286,136.712139526852,5029.42857142857,105.54581064992,1417.71428571429,31.1663288769324
"42",2021-01-26,8156,158579,5979,122110,2177,36469,110029,6988,144.124730752802,5472.42857142857,110.97983258959,1515.57142857143,33.1448981632115
"43",2021-01-27,9618,168197,6482,128592,3136,39605,110029,7508,152.866062583501,5871.28571428571,116.871006734588,1636.71428571429,35.9950558489126
"44",2021-01-28,11513,179710,8839,137431,2674,42279,110029,7997.71428571429,163.329667633079,6365.28571428571,124.904343400376,1632.42857142857,38.4253242327023
"45",2021-01-29,11986,191696,10017,147448,1969,44248,110029,8220.85714285714,174.223159348899,6563.71428571429,134.008306900908,1657.14285714286,40.214852447991
"46",2021-01-30,12277,203973,10831,158279,1446,45694,110029,8600.14285714286,185.381126793845,6872.71428571429,143.85207536195,1727.42857142857,41.5290514318952
"47",2021-01-31,6708,210681,5309,163588,1399,47093,110029,8854.14285714286,191.477701333285,7007.42857142857,148.677166928719,1846.71428571429,42.8005344045661
"48",2021-02-01,2655,213336,2179,165767,476,47569,110029,8987.57142857143,193.890701542321,7090.85714285714,150.657553917604,1896.71428571429,43.2331476247171
"49",2021-02-02,8120,221456,6209,171976,1911,49480,110029,8982.42857142857,201.270574121368,7123.71428571429,156.300611656927,1858.71428571429,44.9699624644412
"50",2021-02-03,12311,233767,8678,180654,3633,53113,110029,9367.14285714286,212.459442510611,7437.42857142857,164.187623262958,1929.71428571429,48.2718192476529
"51",2021-02-04,12998,246765,9920,190574,3078,56191,110029,9579.28571428571,224.272691744904,7591.85714285714,173.203428187114,1987.42857142857,51.0692635577893
"52",2021-02-05,15425,262190,12526,203100,2899,59090,110029,10070.5714285714,238.291723091185,7950.28571428571,184.587699606467,2120.28571428571,53.7040234847177
"53",2021-02-06,16698,278888,12634,215734,4064,63154,110029,10702.1428571429,253.46772214598,8207.85714285714,196.070126966527,2494.28571428571,57.3975951794527
"54",2021-02-07,9081,287969,7026,222760,2055,65209,110029,11041.1428571429,261.721000827055,8453.14285714286,202.455716220269,2588,59.2652846067855
"55",2021-02-08,3187,291156,2632,225392,555,65764,110029,11117.1428571429,264.6175099292,8517.85714285714,204.84781284934,2599.28571428571,59.7696970798608
"56",2021-02-09,9943,301099,7305,232697,2638,68402,110029,11377.5714285714,273.654218433322,8674.42857142857,211.486971616574,2703.14285714286,62.1672468167483
"57",2021-02-10,11445,312544,8156,240853,3289,71691,110029,11253.8571428571,284.056021594307,8599.85714285714,218.899562842523,2654,65.1564587517836
"58",2021-02-11,16378,328922,11333,252186,5045,76736,110029,11736.7142857143,298.941188232193,8801.71428571429,229.19957465759,2935,69.7416135746031
"59",2021-02-12,18344,347266,10499,262685,7845,84581,110029,12153.7142857143,315.61315653146,8512.14285714286,238.74160448609,3641.57142857143,76.8715520453699
"60",2021-02-13,16885,364151,10191,272876,6694,91275,110029,12180.4285714286,330.959110779885,8163.14285714286,248.003708113316,4017.28571428571,82.9554026665697
"61",2021-02-14,11796,375947,8231,281107,3565,94840,110029,12568.2857142857,341.679920748166,8335.28571428571,255.484463186978,4233,86.1954575611884
"62",2021-02-15,3605,379552,2774,283881,831,95671,110029,12628,344.956329694899,8355.57142857143,258.005616701052,4272.42857142857,86.9507129938471
"63",2021-02-16,8328,387880,5709,289590,2619,98290,110029,12397.2857142857,352.525243344936,8127.57142857143,263.194248788956,4269.71428571429,89.3309945559807
"64",2021-02-17,7978,395858,5482,295072,2496,100786,110029,11902,359.776059038981,7745.57142857143,268.176571631115,4156.42857142857,91.5994874078652
"65",2021-02-18,12850,408708,6363,301435,6488,107274,110029,11398,371.454798280453,7035.57142857143,273.959592471076,4362.57142857143,97.4961146606804
"66",2021-02-19,14927,423635,7493,308928,7434,114708,110029,10909.8571428571,385.021221677921,6606.14285714286,280.769615283244,4303.85714285714,104.252515245981
"67",2021-02-20,14426,438061,6528,315456,7898,122606,110029,10558.5714285714,398.132310572667,6082.85714285714,286.702596588172,4475.85714285714,111.430622835798
"68",2021-02-21,8760,446821,4545,320001,4215,126821,110029,10124.8571428571,406.093847985531,5556.28571428571,290.833325759572,4568.71428571429,115.261431077261
"69",2021-02-22,3747,450568,2207,322208,1540,128361,110029,10145.1428571429,409.499313817266,5475.28571428571,292.839160584937,4670,116.661062083632
"70",2021-02-23,10878,461446,4726,326934,6152,134513,110029,10509.4285714286,419.385798289542,5334.85714285714,297.134391842151,5174.71428571429,122.252315298694
"71",2021-02-24,14788,476234,7723,334657,7068,141581,110029,11482.2857142857,432.825891355915,5655,304.153450453971,5827.85714285714,128.676076307155
"72",2021-02-25,15907,492141,8095,342752,7812,149393,110029,11919,447.282989030165,5902.42857142857,311.510601750448,6017,135.776022684929
"73",2021-02-26,18684,510825,8592,351344,10092,159485,110029,12455.7142857143,464.263966772396,6059.42857142857,319.319452144435,6396.71428571429,144.948150033173
"74",2021-02-27,20380,531205,10162,361506,10219,169704,110029,13306.2857142857,482.786356324242,6578.57142857143,328.555199083878,6728.28571428571,154.235701496878
"75",2021-02-28,15698,546903,10748,372254,4950,174654,110029,14297.4285714286,497.053504076198,7464.71428571429,338.323532886784,6833.28571428571,158.734515445928
"76",2021-03-01,6822,553725,4534,376788,2288,176942,110029,14736.7142857143,503.253687664161,7797.14285714286,342.444264693853,6940.14285714286,160.813967226822
"77",2021-03-02,13044,566769,7203,383991,5841,182783,110029,15046.1428571429,515.108744058385,8151,348.990720628198,6895.71428571429,166.122567686701
"78",2021-03-03,15302,582071,8103,392094,7200,189983,110029,15119.5714285714,529.015986694417,8205.28571428571,356.355142735097,6914.57142857143,172.666297067137
"79",2021-03-04,18901,600972,9303,401397,9606,199589,110029,15547.2857142857,546.194185169364,8377.85714285714,364.810186405402,7170.85714285714,181.396722682202
"80",2021-03-05,18359,619331,10289,411686,8208,207797,110029,15500.8571428571,562.879786238174,8620.28571428571,374.161357460306,6901.71428571429,188.856574175899
"81",2021-03-06,19693,639024,11962,423648,8136,215933,110029,15402.7142857143,580.777794944969,8877.42857142857,385.033036744858,6604.14285714286,196.250988375792
"82",2021-03-07,13986,653010,8122,431770,6229,222162,110029,15158.1428571429,593.488989266466,8502.28571428571,392.414727026511,6786.85714285714,201.912223141172
"83",2021-03-08,5821,658831,4245,436015,2350,224512,110029,15015.1428571429,598.779412700288,8461,396.27280080706,6795.71428571429,204.048023702842
"84",2021-03-09,13747,672578,7717,443732,6777,231289,110029,15115.5714285714,611.273391560407,8534.42857142857,403.286406311063,6929.42857142857,210.207308982177
"85",2021-03-10,17396,689974,9821,453553,8267,239556,110029,15414.7142857143,627.083768824583,8779.85714285714,412.212234956239,7081.85714285714,217.720782702742
"86",2021-03-11,22042,712016,14587,468140,8368,247924,110029,15863.4285714286,647.116669241745,9534.71428571429,425.469648910742,6905,225.326050404893
"87",2021-03-12,23847,735863,15123,483263,9648,257572,110029,16647.4285714286,668.790046260531,10225.2857142857,439.214207163566,7110.71428571429,234.094647774678
"88",2021-03-13,27209,763072,17171,500434,11066,268638,110029,17721.1428571429,693.51898135946,10969.4285714286,454.820092884603,7529.28571428571,244.151996291887
"89",2021-03-14,19734,782806,12050,512484,8752,277390,110029,18542.2857142857,711.454252969672,11530.5714285714,465.771751083805,7889.71428571429,252.106262894328
"90",2021-03-15,10173,792979,7447,519931,2952,280342,110029,19164,720.699997273446,11988,472.539966736042,7975.71428571429,254.789191940307
"91",2021-03-16,19255,812234,13509,533440,6325,286667,110029,19950.8571428571,738.199929109598,12815.4285714286,484.817638986086,7911.14285714286,260.537676430759
"92",2021-03-17,22601,834835,15982,549422,7727,294394,110029,20694.4285714286,758.740877405048,13695.5714285714,499.342900508048,7834,267.560370447791
"93",2021-03-18,23234,858069,17339,566761,6661,301055,110029,20864.7142857143,779.857128575194,14088.7142857143,515.101473247962,7590.14285714286,273.614228975997
"94",2021-03-19,24671,882740,17993,584754,7379,308434,110029,20982.4285714286,802.279399067519,14498.7142857143,531.454434739932,7266,280.320642739641
"95",2021-03-20,25765,908505,19197,603951,7558,315992,110029,20776.1428571429,825.695952885149,14788.1428571429,548.90165320052,6764.85714285714,287.189740886494
"96",2021-03-21,18349,926854,12938,616889,7178,323170,110029,20578.2857142857,842.372465440929,14915,560.660371356642,6540,293.713475538267
"97",2021-03-22,12113,938967,9107,625996,3445,326615,110029,20855.4285714286,853.38138127221,15152.1428571429,568.937280171591,6610.42857142857,296.844468276545
"98",2021-03-23,21134,960101,16397,642393,5314,331929,110029,21123.8571428571,872.589044706395,15564.7142857143,583.839714984231,6466,301.674104099828
"99",2021-03-24,24570,984671,19039,661432,6365,338294,110029,21405.1428571429,894.919521217134,16001.4285714286,601.143334938971,6271.42857142857,307.458942642394
"100",2021-03-25,25103,1009774,18899,680331,6963,345257,110029,21672.1428571429,917.734415472285,16224.2857142857,618.319715711312,6314.57142857143,313.787274264058
"101",2021-03-26,28398,1038172,19844,700175,9255,354512,110029,22204.5714285714,943.543974770288,16488.7142857143,636.354960964837,6582.57142857143,322.198693071827
"102",2021-03-27,30785,1068957,19509,719684,12001,366513,110029,22921.7142857143,971.522962128166,16533.2857142857,654.08574103191,7217.28571428571,333.105817557189
"103",2021-03-28,23616,1092573,14868,734552,9653,376166,110029,23674.1428571429,992.986394495997,16809,667.59854220251,7570.85714285714,341.878959183488
"104",2021-03-29,12479,1105052,9964,744516,3332,379498,110029,23726.4285714286,1004.32794990412,16931.4285714286,676.654336583991,7554.71428571429,344.907251724545
"105",2021-03-30,26726,1131778,20583,765099,7103,386601,110029,24525.2857142857,1028.61790982377,17529.4285714286,695.361222950313,7810.28571428571,351.362822528606
"106",2021-03-31,29817,1161595,20872,785971,9827,396428,110029,25274.8571428571,1055.7171291205,17791.2857142857,714.330767343155,8304.85714285714,360.294104281598
"107",2021-04-01,28508,1190103,18639,804610,10967,407395,110029,25761.2857142857,1081.62666206182,17754.1428571429,731.270846776759,8876.85714285714,370.261476519827
"108",2021-04-02,27180,1217283,16783,821393,11395,418790,110029,25587.2857142857,1106.32924047297,17316.8571428571,746.524098192295,9182.57142857143,380.61783711567
"109",2021-04-03,31936,1249219,19252,840645,13866,432656,110029,25751.7142857143,1135.35431568041,17280.1428571429,764.021303474539,9449,393.219969280826
"110",2021-04-04,23598,1272817,15264,855909,10027,442683,110029,25749.1428571429,1156.80138872479,17336.7142857143,777.894009761063,9502.42857142857,402.333021294386
"111",2021-04-05,9065,1281882,3856,859765,5624,448307,110029,25261.4285714286,1165.04012578502,16464.1428571429,781.398540384808,9829.85714285714,407.444401021549
"112",2021-04-06,28121,1310003,17637,877402,13040,461347,110029,25460.7142857143,1190.59793327214,16043.2857142857,797.427950812968,10678,419.295822010561
"113",2021-04-07,34408,1344411,22998,900400,14425,475772,110029,26116.5714285714,1221.8696889002,16347,818.329713075644,11334.8571428571,432.406002054004
"114",2021-04-08,27234,1371645,15653,916053,13917,489689,110029,25934.5714285714,1246.6213452817,15920.4285714286,832.555962518972,11756.2857142857,445.054485635605
"115",2021-04-09,21287,1392932,11804,927857,10859,500548,110029,25092.7142857143,1265.96806296522,15209.1428571429,843.284043297676,11679.7142857143,454.923701933127
