"","date","doses","dosescm","fdoses","fdosescm","sdoses","sdosescm","pop","doses7d","dosert","fdoses7d","fdosert","sdoses7d","sdosert"
"1",2020-12-16,17,17,17,17,0,0,110029,0,0.0154504721482518,0,0.0154504721482518,0,0
"2",2020-12-17,167,184,167,184,0,0,110029,0,0.167228639722255,0,0.167228639722255,0,0
"3",2020-12-18,1976,2160,1976,2160,0,0,110029,0,1.96311881413082,0,1.96311881413082,0,0
"4",2020-12-19,5699,7859,5699,7859,0,0,110029,0,7.14266238900654,0,7.14266238900654,0,0
"5",2020-12-20,3504,11363,3504,11363,0,0,110029,0,10.3272773541521,0,10.3272773541521,0,0
"6",2020-12-21,932,12295,932,12295,0,0,110029,0,11.1743267683974,0,11.1743267683974,0,0
"7",2020-12-22,4224,16519,4224,16519,0,0,110029,2359.85714285714,15.0133146715866,2359.85714285714,15.0133146715866,0,0
"8",2020-12-23,3531,20050,3531,20050,0,0,110029,2861.85714285714,18.2224686219088,2861.85714285714,18.2224686219088,0,0
"9",2020-12-24,2757,22807,2757,22807,0,0,110029,3231.85714285714,20.7281716638341,3231.85714285714,20.7281716638341,0,0
"10",2020-12-25,941,23748,941,23748,0,0,110029,3084,21.583400739805,3084,21.583400739805,0,0
"11",2020-12-26,5,23753,5,23753,0,0,110029,2270.57142857143,21.5879449963192,2270.57142857143,21.5879449963192,0,0
"12",2020-12-27,462,24215,462,24215,0,0,110029,1836,22.0078342982305,1836,22.0078342982305,0,0
"13",2020-12-28,16,24231,16,24231,0,0,110029,1705.14285714286,22.0223759190759,1705.14285714286,22.0223759190759,0,0
"14",2020-12-29,2328,26559,2328,26559,0,0,110029,1434.28571428571,24.1381817520835,1434.28571428571,24.1381817520835,0,0
"15",2020-12-30,4085,30644,4085,30644,0,0,110029,1513.42857142857,27.8508393241782,1513.42857142857,27.8508393241782,0,0
"16",2020-12-31,4937,35581,4937,35581,0,0,110029,1824.85714285714,32.3378382062911,1824.85714285714,32.3378382062911,0,0
"17",2021-01-01,1946,37527,1946,37527,0,0,110029,1968.42857142857,34.1064628416145,1968.42857142857,34.1064628416145,0,0
"18",2021-01-02,276,37803,276,37803,0,0,110029,2007.14285714286,34.3573058011979,2007.14285714286,34.3573058011979,0,0
"19",2021-01-03,1505,39308,1505,39308,0,0,110029,2156.14285714286,35.7251270119696,2156.14285714286,35.7251270119696,0,0
"20",2021-01-04,1085,40393,1054,40362,31,31,110029,2308.85714285714,36.7112306755492,2304.42857142857,36.6830562851612,4.42857142857143,0.0281743903879886
"21",2021-01-05,3694,44087,3446,43808,248,279,110029,2504,40.068527388234,2464.14285714286,39.8149578747421,39.8571428571429,0.253569513491898
"22",2021-01-06,4590,48677,4266,48074,324,603,110029,2576.14285714286,44.240154868262,2490,43.6921175326505,86.1428571428571,0.548037335611521
"23",2021-01-07,4010,52687,3238,51312,772,1375,110029,2443.71428571429,47.8846485926438,2247.28571428571,46.634978051241,196.428571428571,1.24967054140272
"24",2021-01-08,6238,58925,2993,54305,3245,4620,110029,3056.85714285714,53.5540630197493,2396.85714285714,49.3551700006362,660,4.19889301911314
"25",2021-01-09,9093,68018,3792,58097,5301,9921,110029,4316.42857142857,61.8182479164584,2899.14285714286,52.8015341409992,1417.28571428571,9.0167137754592
"26",2021-01-10,4120,72138,1401,59498,2719,12640,110029,4690,65.5627152841524,2884.28571428571,54.0748348162757,1805.71428571429,11.4878804678766
"27",2021-01-11,1588,73726,823,60321,765,13405,110029,4761.85714285714,67.0059711530596,2851.28571428571,54.8228194385117,1910.57142857143,12.183151714548
"28",2021-01-12,5802,79528,2141,62462,3661,17066,110029,5063,72.2791264121277,2664.85714285714,56.7686700778886,2398.14285714286,15.5104563342392
"29",2021-01-13,6790,86318,3775,66237,3015,20081,110029,5377.28571428571,78.4502267584,2594.71428571429,60.1995837461033,2782.57142857143,18.2506430122968
"30",2021-01-14,6628,92946,4246,70483,2382,22463,110029,5751.28571428571,84.4740931936126,2738.71428571429,64.0585663779549,3012.57142857143,20.4155268156577
"31",2021-01-15,4782,97728,3910,74393,872,23335,110029,5543.28571428571,88.8202201237855,2869.71428571429,67.6121749720528,2673.57142857143,21.2080451517327
"32",2021-01-16,4360,102088,3806,78199,554,23889,110029,4867.14285714286,92.7828118041607,2871.71428571429,71.0712630306556,1995.42857142857,21.7115487735052
"33",2021-01-17,3004,105092,2502,80701,502,24391,110029,4707.71428571429,95.5130011178871,3029,73.3452089903571,1678.71428571429,22.16779212753
"34",2021-01-18,1338,106430,899,81600,439,24830,110029,4672,96.7290441610848,3039.85714285714,74.1622663116088,1632.14285714286,22.566777849476
"35",2021-01-19,4628,111058,3027,84627,1601,26431,110029,4504.28571428571,100.935207990621,3166.42857142857,76.9133592053004,1337.85714285714,24.0218487853202
"36",2021-01-20,5907,116965,3618,88245,2289,28720,110029,4378.14285714286,106.303792636487,3144,80.2015832189695,1234.14285714286,26.1022094175172
"37",2021-01-21,8060,125025,5276,93521,2784,31504,110029,4582.71428571429,113.629134137364,3291.14285714286,84.9966826927446,1291.57142857143,28.6324514446191
"38",2021-01-22,10357,135382,8479,102000,1878,33382,110029,5379.14285714286,123.04210708086,3943.85714285714,92.7028328895109,1435.28571428571,30.3392741913496
"39",2021-01-23,9720,145102,8619,110619,1101,34483,110029,6144.85714285714,131.876141744449,4631.42857142857,100.536222268675,1513.42857142857,31.3399194757746
"40",2021-01-24,4866,149968,4173,114792,693,35176,110029,6410.85714285714,136.298612184061,4870.14285714286,104.328858755419,1540.71428571429,31.9697534286415
"41",2021-01-25,1720,151688,1502,116294,218,35394,110029,6465.42857142857,137.861836424943,4956.28571428571,105.693953412282,1509.14285714286,32.1678830126603
"42",2021-01-26,8347,160035,5795,122089,2552,37946,110029,6996.71428571429,145.448018249734,5351.71428571429,110.96074671223,1645,34.4872715375038
"43",2021-01-27,9625,169660,6320,128409,3305,41251,110029,7527.85714285714,154.195712039553,5737.71428571429,116.704686946169,1790.14285714286,37.4910250933845
"44",2021-01-28,11539,181199,8632,137041,2907,44158,110029,8024.85714285714,164.682947223005,6217.14285714286,124.549891392269,1807.71428571429,40.1330558307355
"45",2021-01-29,12097,193296,9936,146977,2161,46319,110029,8273.42857142857,175.67732143344,6425.28571428571,133.580237937271,1848.14285714286,42.0970834961692
"46",2021-01-30,12637,205933,10914,157891,1723,48042,110029,8690.14285714286,187.162475347408,6753.14285714286,143.499441056449,1937,43.6630342909597
"47",2021-01-31,6549,212482,5089,162980,1460,49502,110029,8930.57142857143,193.114542529697,6884,148.124585336593,2046.57142857143,44.9899571931036
"48",2021-02-01,2690,215172,2070,165050,620,50122,110029,9069.14285714286,195.559352534332,6965.14285714286,150.005907533468,2104,45.5534450008634
"49",2021-02-02,8469,223641,6336,171386,2133,52255,110029,9086.57142857143,203.25641421807,7042.42857142857,155.764389388252,2044.14285714286,47.4920248298176
"50",2021-02-03,12477,236118,8663,180049,3814,56069,110029,9494,214.596151923584,7377.14285714286,163.637768224741,2116.85714285714,50.958383698843
"51",2021-02-04,13251,249369,10005,190054,3246,59315,110029,9738.57142857143,226.639340537495,7573.28571428571,172.730825509638,2165.28571428571,53.9085150278563
"52",2021-02-05,15585,264954,12406,202460,3179,62494,110029,10236.8571428571,240.80378809223,7926.14285714286,184.006034772651,2310.71428571429,56.7977533195794
"53",2021-02-06,16801,281755,12494,214954,4307,66801,110029,10831.7142857143,256.073398831217,8151.85714285714,195.361222950313,2679.85714285714,60.7121758809041
"54",2021-02-07,9105,290860,6964,221918,2141,68942,110029,11196.8571428571,264.34848994356,8419.71428571429,201.690463423279,2777.14285714286,62.658026520281
"55",2021-02-08,3211,294071,2438,224356,773,69715,110029,11271.2857142857,267.266811476974,8472.28571428571,203.906242899599,2799,63.3605685773751
"56",2021-02-09,10228,304299,7299,231655,2929,72644,110029,11522.5714285714,276.562542602405,8609.85714285714,210.539948559016,2912.71428571429,66.0225940433886
"57",2021-02-10,11517,315816,8124,239779,3393,76037,110029,11385.4285714286,287.029783057194,8532.85714285714,217.923456543275,2852.57142857143,69.1063265139191
"58",2021-02-11,16440,332256,11161,250940,5279,81316,110029,11841,301.971298475856,8698,228.067145934254,3143,73.9041525416027
"59",2021-02-12,18327,350583,10459,261399,7868,89184,110029,12232.7142857143,318.627816302975,8419.85714285714,237.57282171064,3812.85714285714,81.0549945923348
"60",2021-02-13,17086,367669,10262,271661,6824,96008,110029,12273.4285714286,334.156449663271,8101,246.899453780367,4172.42857142857,87.2569958829036
"61",2021-02-14,11731,379400,8177,279838,3554,99562,110029,12648.5714285714,344.818184296867,8274.28571428571,254.331130883676,4374.28571428571,90.4870534131911
"62",2021-02-15,3623,383023,2764,282602,859,100421,110029,12707.4285714286,348.110952567051,8320.85714285714,256.843195884721,4386.57142857143,91.2677566823292
"63",2021-02-16,8562,391585,5742,288344,2820,103241,110029,12469.4285714286,355.892537421952,8098.42857142857,262.061820065619,4371,93.8307173563333
"64",2021-02-17,8182,399767,5367,293711,2815,106056,110029,11993,363.328758781776,7704.57142857143,266.939625007952,4288.42857142857,96.3891337738233
"65",2021-02-18,12924,412691,6367,300078,6557,112613,110029,11490.7142857143,375.074753019658,7019.71428571429,272.726281253124,4471,102.348471766534
"66",2021-02-19,15048,427739,7458,307536,7590,120203,110029,11022.2857142857,388.75114742477,6591,279.504494269693,4431.28571428571,109.246653155077
"67",2021-02-20,14791,442530,6566,314102,8225,128428,110029,10694.4285714286,402.193967045052,6063,285.472011924129,4631.42857142857,116.721955120923
"68",2021-02-21,8606,451136,4483,318585,4123,132551,110029,10248,410.015541357279,5535.28571428571,289.546392314753,4712.71428571429,120.469149042525
"69",2021-02-22,3731,454867,2182,320767,1549,134100,110029,10263.4285714286,413.406465568168,5452.14285714286,291.529505857547,4811.28571428571,121.876959710622
"70",2021-02-23,10770,465637,4692,325459,6078,140178,110029,10578.8571428571,423.194794099737,5302.14285714286,295.793836170464,5276.71428571429,127.400957929273
"71",2021-02-24,14926,480563,7539,332998,7387,147565,110029,11542.2857142857,436.760308645902,5612.42857142857,302.645666142562,5929.85714285714,134.11464250334
"72",2021-02-25,16237,496800,8157,341155,8080,155645,110029,12015.5714285714,451.517327250089,5868.14285714286,310.059166219815,6147.42857142857,141.458161030274
"73",2021-02-26,19005,515805,8693,349848,10312,165957,110029,12580.8571428571,468.790046260531,6044.57142857143,317.959810595388,6536.28571428571,150.830235665143
"74",2021-02-27,20511,536316,10031,359879,10480,176437,110029,13398,487.431495333049,6539.57142857143,327.07649801416,6858.42857142857,160.354997318889
"75",2021-02-28,15387,551703,10459,370338,4929,181366,110029,14366.7142857143,501.415990329822,7393.28571428571,336.582173790546,6973.57142857143,164.834725390579
"76",2021-03-01,6602,558305,4465,374803,2139,183505,110029,14776.8571428571,507.416226631161,7719.42857142857,340.640194857719,7057.85714285714,166.77875832735
"77",2021-03-02,14025,572330,7794,382597,6266,189771,110029,15241.8571428571,520.162866153469,8162.57142857143,347.723781912041,7084.71428571429,172.473620590935
"78",2021-03-03,15889,588219,8437,391034,7457,197228,110029,15379.4285714286,534.603604504267,8290.85714285714,355.391760354088,7094.71428571429,179.250924756201
"79",2021-03-04,19260,607479,9213,400247,10066,207294,110029,15811.2857142857,552.108080596934,8441.71428571429,363.765007407138,7378.42857142857,188.399421970571
"80",2021-03-05,19242,626721,10467,410714,8912,216206,110029,15845.1428571429,569.596197366149,8695.14285714286,373.277953993947,7178.42857142857,196.499104781467
"81",2021-03-06,20780,647501,12276,422990,8906,225112,110029,15883.5714285714,588.48212743913,9015.85714285714,384.435012587591,6953.57142857143,204.593334484545
"82",2021-03-07,14217,661718,8051,431041,6516,231628,110029,15716.4285714286,601.403266411582,8671.85714285714,391.752174426742,7180.28571428571,210.51540957384
"83",2021-03-08,6036,667754,4343,435384,2522,234150,110029,15635.5714285714,606.889092875515,8654.42857142857,395.699315634969,7235,212.807532559598
"84",2021-03-09,14451,682205,7996,443380,7200,241350,110029,15696.4285714286,620.022903052832,8683.28571428571,402.966490652464,7368.42857142857,219.351261940034
"85",2021-03-10,18505,700710,10492,453872,8725,250075,110029,16070.1428571429,636.841196411855,8976.85714285714,412.502158521844,7549.57142857143,227.280989557299
"86",2021-03-11,23161,723871,15055,468927,9036,259111,110029,16627.4285714286,657.891101436894,9811.42857142857,426.184914886075,7402.42857142857,235.493369929746
"87",2021-03-12,24630,748501,15472,484399,10086,269197,110029,17397.1428571429,680.276109025802,10526.4285714286,440.24666224359,7570.14285714286,244.660044170173
"88",2021-03-13,28190,776691,17235,501634,11986,281183,110029,18455.7142857143,705.896627252815,11234.8571428571,455.910714448009,8010.14285714286,255.553535885994
"89",2021-03-14,19862,796553,11810,513444,9135,290318,110029,19262.1428571429,723.94823182979,11771.8571428571,466.64424833453,8384.28571428571,263.855892537422
"90",2021-03-15,10432,806985,7336,520780,3318,293636,110029,19890.1428571429,733.429368621,12199.4285714286,473.311581492152,8498,266.87146116024
"91",2021-03-16,20511,827496,14071,534851,7136,300772,110029,20755.8571428571,752.070817693517,13067.2857142857,486.10002817439,8488.85714285714,273.357024057294
"92",2021-03-17,23113,850609,16067,550918,8213,308985,110029,21414.1428571429,773.07709785602,13863.7142857143,500.702542057094,8415.71428571429,280.821419807505
"93",2021-03-18,23883,874492,17334,568252,7391,316376,110029,21517.2857142857,794.783193521708,14189.2857142857,516.456570540494,8180.71428571429,287.538739786783
"94",2021-03-19,25117,899609,17988,586240,7888,324264,110029,21586.8571428571,817.610811695099,14548.7142857143,532.80498777595,7866.71428571429,294.707758863572
"95",2021-03-20,26706,926315,19429,605669,8425,332689,110029,21374.8571428571,841.882594588699,14862.1428571429,550.463059738796,7358,302.364831089985
"96",2021-03-21,18510,944825,12968,618637,0,339990,110029,21181.7142857143,858.705432204237,15027.5714285714,562.249043434004,6053,309.000354452008
"97",2021-03-22,12132,956957,8525,627162,4067,344057,110029,21424.5714285714,869.731616210272,15197.4285714286,569.997000790701,6160,312.696652700652
"98",2021-03-23,21626,978583,16500,643662,5739,349796,110029,21583.8571428571,889.386434485454,15544.4285714286,584.993047287533,5960.42857142857,317.912550327641
"99",2021-03-24,25536,1004119,19561,663223,6835,356631,110029,21930,912.594861354734,16043.5714285714,602.771087622354,5763.57142857143,324.124548982541
"100",2021-03-25,27158,1031277,20024,683247,7951,364582,110029,22397.8571428571,937.277445037217,16427.8571428571,620.969926110389,5843.57142857143,331.350825691409
"101",2021-03-26,28995,1060272,19849,703096,9878,374460,110029,22951.8571428571,963.629588563015,16693.7142857143,639.009715620427,6127.85714285714,340.328458860846
"102",2021-03-27,31591,1091863,19407,722503,12990,387450,110029,23649.7142857143,992.341110070981,16690.5714285714,656.647792854611,6780,352.134437284716
"103",2021-03-28,24110,1115973,15017,737520,0,397395,110029,24449.7142857143,1014.25351498241,16983.2857142857,670.296012869335,6780,361.172963491443
"104",2021-03-29,12366,1128339,9734,747254,3748,401143,110029,24483.1428571429,1025.49237019331,17156,679.142771451163,6734.42857142857,364.579338174481
"105",2021-03-30,27366,1155705,20499,767753,8065,409208,110029,25303.1428571429,1050.36399494679,17727.2857142857,697.773314308046,7066.71428571429,371.909223931873
"106",2021-03-31,30864,1186569,20977,788730,10914,420122,110029,26064.2857142857,1078.41478155759,17929.5714285714,716.838288087686,7649.42857142857,381.82842705105
"107",2021-04-01,31539,1218108,20482,809212,12270,432392,110029,26690.1428571429,1107.07904279781,17995,735.453380472421,8266.42857142857,392.980032536877
"108",2021-04-02,33046,1251154,21164,830376,13200,445592,110029,27268.8571428571,1137.1129429514,18182.8571428571,754.688309445692,8741,404.976869734343
"109",2021-04-03,34356,1285510,19365,849741,16646,462238,110029,27663.8571428571,1168.33743831172,18176.8571428571,772.288214925156,9263.28571428571,420.10560852139
"110",2021-04-04,25293,1310803,14900,864641,0,474618,110029,27832.8571428571,1191.32501431441,18160.1428571429,785.830099337447,9263.28571428571,431.357187650528
"111",2021-04-05,9272,1320075,3389,868030,6308,480926,110029,27390.8571428571,1199.75188359433,17253.7142857143,788.910196402767,9629,437.090221668833
"112",2021-04-06,30033,1350108,17526,885556,0,496348,110029,27771.8571428571,1227.04741477247,16829,804.838724336311,8476.85714285714,451.106526461206
"113",2021-04-07,39453,1389561,25516,911072,0,514243,110029,28998.8571428571,1262.90432522335,17477.4285714286,828.028974179535,6917.71428571429,467.370420525498
"114",2021-04-08,34730,1424291,18176,929248,0,534446,110029,29454.7142857143,1294.46873097093,17148,844.548255459924,5164.85714285714,485.731943396741
"115",2021-04-09,35161,1459452,18411,947659,19932,554378,110029,29756.8571428571,1326.42485163002,16754.7142857143,861.281116796481,6126.57142857143,503.847167564915
"116",2021-04-10,37509,1496961,19728,967387,21187,575565,110029,30207.2857142857,1360.51495514819,16806.5714285714,879.210935298876,6775.28571428571,523.103000118151
"117",2021-04-11,28383,1525344,16353,983740,0,591925,110029,30648.7142857143,1386.31088167665,17014.1428571429,894.073380654191,6775.28571428571,537.971807432586
"118",2021-04-12,14596,1539940,7641,991381,9356,601281,110029,31409.2857142857,1399.57647529288,17621.5714285714,901.017913459179,7210.71428571429,546.475020221941
"119",2021-04-13,28427,1568367,13607,1004988,18388,619669,110029,31179.8571428571,1425.41239127866,17061.7142857143,913.3846531369,9837.57142857143,563.186977978533
"120",2021-04-14,32511,1600878,14632,1019620,17923,637592,110029,30188.1428571429,1454.96005598524,15506.8571428571,926.682965400031,12398,579.476319879305
"121",2021-04-15,31214,1632092,14407,1034027,16813,654405,110029,29685.8571428571,1483.32894055204,14968.4285714286,939.776786120023,14799.8571428571,594.756836833926
"122",2021-04-16,34068,1666160,14949,1048976,0,673613,110029,29529.7142857143,1514.29168673713,14473.8571428571,953.363204246153,11952.4285714286,612.214052658844
"123",2021-04-17,32111,1698271,13414,1062390,18707,692320,110029,28758.5714285714,1543.47581092257,13571.8571428571,965.554535622427,11598.1428571429,629.215933981041
"124",2021-04-18,26612,1724883,12213,1074603,14412,706732,110029,28505.5714285714,1567.66216179371,12980.4285714286,976.654336583991,13657,642.314298957548
"125",2021-04-19,13289,1738172,3927,1078530,9365,716097,110029,28318.8571428571,1579.73988675713,12449.8571428571,980.223395650238,13658.2857142857,650.825691408629
"126",2021-04-20,29144,1767316,9347,1087877,19822,735919,110029,28421.2857142857,1606.22744912705,11841.2857142857,988.718428777868,13863.1428571429,668.84094193349
"127",2021-04-21,34055,1801371,15163,1103040,18917,754836,110029,28641.8571428571,1637.17838024521,11917.1428571429,1002.49934108281,14005.1428571429,686.033682029283
"128",2021-04-22,31532,1832903,14095,1117135,17451,772287,110029,28687.2857142857,1665.83627952631,11872.5714285714,1015.30960019631,14096.2857142857,701.894046115115
"129",2021-04-23,33673,1866576,16695,1133830,16987,789274,110029,28630.8571428571,1696.44002944678,12122,1030.4828726972,16523,717.33270319643
"130",2021-04-24,31365,1897941,13676,1147506,17691,806965,110029,28524.2857142857,1724.94615056031,12159.4285714286,1042.91232311482,16377.8571428571,733.411191594943
"131",2021-04-25,25383,1923324,12938,1160444,12478,819443,110029,28348.7142857143,1748.01552318025,12263,1054.67104127094,16101.5714285714,744.75183815176
"132",2021-04-26,8602,1931926,4582,1165026,4024,823467,110029,27679.1428571429,1755.83346208727,12356.5714285714,1058.83539794054,15338.5714285714,748.409055794382
"133",2021-04-27,24529,1956455,8822,1173848,15760,839227,110029,27019.8571428571,1778.12667569459,12281.5714285714,1066.85328413418,14758.2857142857,762.732552327114
"134",2021-04-28,29799,1986254,9083,1182931,0,860245,110029,26411.8571428571,1805.20953566787,11413,1075.10838051786,12055.8571428571,781.83478901017
"135",2021-04-29,26441,2012695,9386,1192317,17536,877781,110029,25684.5714285714,1829.24047296622,10740.2857142857,1083.6388588463,12068,797.772405456743
"136",2021-04-30,25448,2038143,8989,1201306,16939,894720,110029,24509.5714285714,1852.36892092085,9639.42857142857,1091.80852320752,12061.1428571429,813.167437675522
"137",2021-05-01,27336,2065479,11223,1212529,16749,911469,110029,23934,1877.21328013524,9289,1102.00856137927,11926.5714285714,828.389788146761
"138",2021-05-02,16756,2082235,6217,1218746,10922,922391,110029,22701.5714285714,1892.4419925656,8328.85714285714,1107.65888992902,11704.2857142857,838.316262076362
"139",2021-05-03,6327,2088562,2371,1221117,4317,926708,110029,22376.5714285714,1898.19229475865,8013,1109.81377636805,11746.1428571429,842.239773150715
"140",2021-05-04,16021,2104583,4750,1225867,11936,938644,110029,21161.1428571429,1912.75300148143,7431.28571428571,1114.13082005653,11199.8571428571,853.087822301393
"141",2021-05-05,19953,2124536,6647,1232514,14170,952814,110029,19754.5714285714,1930.88731152696,7083.28571428571,1120.1719546665,13224.1428571429,865.966245262613
"142",2021-05-06,20267,2144803,7555,1240069,13388,966202,110029,18872.5714285714,1949.30700088159,6821.71428571429,1127.03832625944,12631.5714285714,878.133946505012
"143",2021-05-07,19762,2164565,6279,1246348,14097,980299,110029,18060.2857142857,1967.26772032828,6434.57142857143,1132.74500358996,12225.5714285714,890.946023321124
"144",2021-05-08,19782,2184347,6480,1252828,13916,994215,110029,16981.1428571429,1985.24661680103,5757,1138.63436003236,11820.8571428571,903.593598051423
"145",2021-05-09,17243,2201590,5003,1257831,12844,1007059,110029,17050.7142857143,2000.91793981587,5583.57142857143,1143.18134310046,12095.4285714286,915.266884185079
"146",2021-05-10,4554,2206144,1769,1259600,3242,1010301,110029,16797.4285714286,2005.05684864899,5497.57142857143,1144.78910105518,11941.8571428571,918.21338010888
"147",2021-05-11,13153,2219297,4320,1263920,9654,1019955,110029,16387.7142857143,2017.01096983523,5436.14285714286,1148.71533868344,11615.8571428571,926.987430586482
"148",2021-05-12,19813,2239110,5488,1269408,14832,1034787,110029,16367.7142857143,2035.01804069836,5270.57142857143,1153.70311463341,11710.4285714286,940.46751311018
"149",2021-05-13,18113,2257223,5188,1274596,13452,1048239,110029,16060,2051.48006434667,4932.42857142857,1158.41823519254,11719.5714285714,952.693380835961
"150",2021-05-14,23898,2281121,8099,1282695,0,1064391,110029,16650.8571428571,2073.1997927819,5192.42857142857,1165.77902189423,9705.71428571429,967.373147079406
"151",2021-05-15,22733,2303854,9588,1292283,13630,1078021,110029,17072.4285714286,2093.86070944933,5636.42857142857,1174.49308818584,9664.85714285714,979.760790337093
"152",2021-05-16,21653,2325507,9737,1302020,12358,1090379,110029,17702.4285714286,2113.54006670969,6312.71428571429,1183.34257332158,9595.42857142857,990.992374737569
"153",2021-05-17,10219,2335726,5448,1307468,5171,1095550,110029,18511.7142857143,2122.82761817339,6838.28571428571,1188.29399521944,9871,995.692044824546
"154",2021-05-18,17829,2353555,7797,1315265,10617,1106167,110029,19179.7142857143,2139.0315280517,7335,1195.38030882767,10008.5714285714,1005.34131910678
"155",2021-05-19,18212,2371767,8137,1323402,10600,1116767,110029,18951,2155.58352797899,7713.42857142857,1202.77563187887,9404,1014.97514291687
"156",2021-05-20,17663,2389430,8727,1332129,9511,1126278,110029,18886.7142857143,2171.63656854102,8219,1210.70717719874,8841,1023.61922765816
"157",2021-05-21,15016,2404446,6705,1338834,8815,1135093,110029,17617.8571428571,2185.28387970444,8019.85714285714,1216.80102518427,10100.2857142857,1031.63075189268
"158",2021-05-22,17520,2421966,7490,1346324,10541,1145634,110029,16873.1428571429,2201.20695453017,7720.14285714286,1223.60832144253,9659,1041.2109534759
"159",2021-05-23,15001,2436967,7834,1354158,7555,1153189,110029,15922.8571428571,2214.84063292405,7448.28571428571,1230.72826254896,8972.85714285714,1048.07732506885
"160",2021-05-24,6222,2443189,3728,1357886,2769,1155958,110029,15351.8571428571,2220.49550573031,7202.57142857143,1234.11646020595,8629.71428571429,1050.5939343264
"161",2021-05-25,12338,2455527,5986,1363872,6887,1162845,110029,14567.4285714286,2231.70891310473,6943.85714285714,1239.55684410474,8096.85714285714,1056.85319324905
"162",2021-05-26,11952,2467479,5323,1369195,7028,1169873,110029,13673.1428571429,2242.57150387625,6541.85714285714,1244.39465958974,7586.57142857143,1063.2406002054
"163",2021-05-27,12746,2480225,5957,1375152,7191,1177064,110029,12970.7142857143,2254.15572258223,6146.14285714286,1249.80868680075,7255.14285714286,1069.77614992411
"164",2021-05-28,10505,2490730,4584,1379736,6259,1183323,110029,12326.2857142857,2263.70320551855,5843.14285714286,1253.97486117296,6890,1075.46465022858
"165",2021-05-29,11754,2502484,4319,1384055,7822,1191145,110029,11502.5714285714,2274.38584373211,5390.14285714286,1257.90018994992,6501.57142857143,1082.57368511938
"166",2021-05-30,8222,2510706,4069,1388124,4504,1195649,110029,10534.1428571429,2281.85841914404,4852.28571428571,1261.59830590117,6065.71428571429,1086.66715138736
"167",2021-05-31,3115,2513821,1703,1389827,1637,1197286,110029,10090.2857142857,2284.68949095239,4563,1263.14607966991,5904,1088.15494097011
"168",2021-06-01,897,2514718,462,1390289,549,1197835,110029,8455.85714285714,2285.50473057103,3773.85714285714,1263.56596897182,4998.57142857143,1088.65390033537
"169",2021-06-02,11249,2525967,4543,1394832,7071,1204906,110029,8355.42857142857,2295.72839887666,3662.42857142857,1267.69488044061,5004.71428571429,1095.08038789774
"170",2021-06-03,10720,2536687,4822,1399654,6184,1211090,110029,8066,2305.47128484309,3500.28571428571,1272.0773614229,4860.85714285714,1100.70072435449
"171",2021-06-04,11424,2548111,3802,1403456,7934,1219024,110029,8197.28571428571,2315.85400212671,3388.57142857143,1275.53281407629,5100.14285714286,1107.91155059121
"172",2021-06-05,12335,2560446,4030,1407486,8648,1227672,110029,8280.28571428571,2327.06468294722,3347.28571428571,1279.19548482673,5218.14285714286,1115.77129665815
"173",2021-06-06,11393,2571839,3605,1411091,8118,1235790,110029,8733.28571428571,2337.41922584046,3281,1282.47189377346,5734.42857142857,1123.1493515346
"174",2021-06-07,6319,2578158,1469,1412560,5067,1240857,110029,9191,2343.1622572231,3247.57142857143,1283.80699633733,6224.42857142857,1127.75450108608
"175",2021-06-08,10520,2588678,3443,1416003,7475,1248332,110029,10565.7142857143,2352.72337292896,3673.42857142857,1286.936171373,7213.85714285714,1134.54816457479
"176",2021-06-09,10648,2599326,3383,1419386,7636,1255968,110029,10479.8571428571,2362.40082160158,3507.71428571429,1290.0108153305,7294.57142857143,1141.48815312327
"177",2021-06-10,10964,2610290,3557,1422943,7713,1263681,110029,10514.7142857143,2372.3654672859,3327,1293.2435994147,7513,1148.49812322206
"178",2021-06-11,9558,2619848,3556,1426499,6376,1270057,110029,10248.1428571429,2381.05226803843,3291.85714285714,1296.47547464759,7290.42857142857,1154.29295912896
"179",2021-06-12,10605,2630453,3673,1430172,7331,1277388,110029,10001,2390.69063610503,3240.85714285714,1299.81368548292,7102.28571428571,1160.95574803006
"180",2021-06-13,9076,2639529,2699,1432871,6671,1284059,110029,9670,2398.93937052959,3111.42857142857,1302.26667514928,6895.57142857143,1167.0186950713
"181",2021-06-14,4405,2643934,1112,1433983,3504,1287563,110029,9396.57142857143,2402.94286051859,3060.42857142857,1303.27731779804,6672.28571428571,1170.20331003644
"182",2021-06-15,8814,2652748,3302,1437285,5878,1293441,110029,9152.85714285714,2410.95347590181,3040.28571428571,1306.27834480001,6444.14285714286,1175.54553799453
"183",2021-06-16,8332,2661080,3265,1440550,5466,1298907,110029,8822,2418.52602495706,3023.42857142857,1309.24574430377,6134.14285714286,1180.51331921584
"184",2021-06-17,8442,2669522,3125,1443675,5612,1304519,110029,8461.71428571429,2426.19854765562,2961.71428571429,1312.08590462514,5834,1185.61379272737
"185",2021-06-18,7044,2676566,2710,1446385,4602,1309121,110029,8102.57142857143,2432.60049623281,2840.85714285714,1314.54889165584,5580.57142857143,1189.79632642303
"186",2021-06-19,7046,2683612,2713,1449098,4621,1313742,110029,7594.14285714286,2439.00426251261,2703.71428571429,1317.01460524044,5193.42857142857,1193.99612829345
"187",2021-06-20,6122,2689734,2265,1451363,4110,1317852,110029,7172.14285714286,2444.56825018859,2641.71428571429,1319.07315344137,4827.57142857143,1197.73150714812
"188",2021-06-21,2264,2691998,1019,1452382,1411,1319263,110029,6866.28571428571,2446.62588953821,2628.42857142857,1319.99927291896,4528.57142857143,1199.01389633642
"189",2021-06-22,5175,2697173,2574,1454956,2922,1322185,110029,6346.42857142857,2451.3291950304,2524.42857142857,1322.33865617246,4106.28571428571,1201.66955984331
"190",2021-06-23,6299,2703472,2562,1457518,3986,1326171,110029,6056,2457.05404938698,2424,1324.66713321034,3894.85714285714,1205.29224113643
"191",2021-06-24,7323,2710795,2994,1460512,4632,1330803,110029,5896.14285714286,2463.70956747767,2405.28571428571,1327.38823401103,3754.85714285714,1209.50204037117
"192",2021-06-25,6093,2716888,2608,1463120,3752,1334555,110029,5760.28571428571,2469.24719846586,2390.71428571429,1329.75851820884,3633.42857142857,1212.91205045942
"193",2021-06-26,6470,2723358,2821,1465941,3922,1338477,110029,5678,2475.12746639522,2406.14285714286,1332.32238773414,3533.57142857143,1216.47656526916
"194",2021-06-27,5225,2728583,2157,1468098,3379,1341856,110029,5549.85714285714,2479.87621445255,2390.71428571429,1334.28277999437,3429.14285714286,1219.54757382145
"195",2021-06-28,2298,2730881,1107,1469205,1319,1343175,110029,5554.71428571429,2481.96475474648,2403.28571428571,1335.28887838661,3416,1220.74634868989
"196",2021-06-29,5132,2736013,2498,1471703,2926,1346101,110029,5548.57142857143,2486.62897963264,2392.42857142857,1337.5591889411,3416.57142857143,1223.405647602
"197",2021-06-30,5154,2741167,2305,1474008,3083,1349184,110029,5385,2491.31319924747,2355.71428571429,1339.65409119414,3287.57142857143,1226.20763616865
"198",2021-07-01,5926,2747093,2770,1476778,3367,1352551,110029,5185.42857142857,2496.69905206809,2323.71428571429,1342.171609303,3106.85714285714,1229.2677385053
"199",2021-07-02,4864,2751957,2147,1478925,2915,1355466,110029,5009.85714285714,2501.1197048051,2257.85714285714,1344.1229130502,2987.28571428571,1231.91704005308
"200",2021-07-03,5090,2757047,2209,1481134,3113,1358579,110029,4812.71428571429,2505.74575793654,2170.42857142857,1346.13056557817,2871.71428571429,1234.74629415881
"201",2021-07-04,3443,2760490,1433,1482567,2138,1360717,110029,4558.14285714286,2508.87493297222,2067,1347.43294949513,2694.42857142857,1236.68941824428
"202",2021-07-05,208,2760698,93,1482660,132,1360849,110029,4259.57142857143,2509.06397404321,1922.14285714286,1347.5174726663,2524.85714285714,1236.80938661626
"203",2021-07-06,3155,2763853,1537,1484197,1789,1362638,110029,3977.14285714286,2511.93139990366,1784.85714285714,1348.91437711876,2362.42857142857,1238.43532159703
"204",2021-07-07,5052,2768905,1964,1486161,3296,1365934,110029,3962.57142857143,2516.5229166856,1736.14285714286,1350.69936107753,2392.85714285714,1241.43089549119
"205",2021-07-08,5082,2773987,2188,1488349,3119,1369053,110029,3842,2521.14169900663,1653,1352.68792772814,2357.42857142857,1244.26560270474
"206",2021-07-09,4332,2778319,1966,1490315,2581,1371634,110029,3766,2525.07884285052,1627.14285714286,1354.47472938952,2309.71428571429,1246.61134791737
"207",2021-07-10,5009,2783328,2287,1492602,3000,1374634,110029,3754.42857142857,2529.63127902644,1638.28571428571,1356.55327231912,2293.57142857143,1249.33790182588
"208",2021-07-11,3948,2787276,1908,1494510,2226,1376860,110029,3826.57142857143,2533.21942397004,1706.14285714286,1358.28736060493,2306.14285714286,1251.361004826
"209",2021-07-12,1797,2789073,925,1495435,976,1377836,110029,4053.57142857143,2534.85262976124,1825,1359.12804806006,2426.71428571429,1252.24804369757
"210",2021-07-13,4478,2793551,2238,1497673,2505,1380341,110029,4242.57142857143,2538.92246589535,1925.14285714286,1361.16205727581,2529,1254.52471621118
"211",2021-07-14,4208,2797759,2068,1499741,2311,1382652,110029,4122,2542.7469121777,1940,1363.04156177008,2388.28571428571,1256.62507157204
"212",2021-07-15,4396,2802155,2038,1501779,2511,1385163,110029,4024,2546.74222250498,1918.57142857143,1364.89380072526,2301.42857142857,1258.90719719347
"213",2021-07-16,4067,2806222,2028,1503807,2172,1387335,110029,3986.14285714286,2550.43852075362,1927.42857142857,1366.73695116742,2243,1260.88122222323
"214",2021-07-17,4765,2810987,2302,1506109,2624,1389959,110029,3951.28571428571,2554.76919721164,1929.57142857143,1368.82912686655,2189.28571428571,1263.26604804188
"215",2021-07-18,3309,2814296,1587,1507696,1834,1391793,110029,3860,2557.77658617274,1883.71428571429,1370.27147388416,2133.28571428571,1264.93288133129
"216",2021-07-19,1780,2816076,891,1508587,980,1392773,110029,3857.57142857143,2559.39434149179,1878.85714285714,1371.08126039499,2133.85714285714,1265.82355560807
"217",2021-07-20,4497,2820573,2352,1510939,2376,1395149,110029,3860.28571428571,2563.48144580065,1895.14285714286,1373.21887865926,2115.42857142857,1267.98298630361
"218",2021-07-21,4286,2824859,2287,1513226,2192,1397341,110029,3871.42857142857,2567.37678248462,1926.42857142857,1375.29742158885,2098.42857142857,1269.97518835943
"219",2021-07-22,4801,2829660,2459,1515685,2533,1399874,110029,3929.28571428571,2571.74017758954,1986.57142857143,1377.53228694253,2101.57142857143,1272.27730870952
"220",2021-07-23,4408,2834068,2624,1518309,1934,1401808,110029,3978,2575.74639413246,2071.71428571429,1379.91711276118,2067.57142857143,1274.03502712921
"221",2021-07-24,4870,2838938,2911,1521220,2121,1403929,110029,3993,2580.17249997728,2158.71428571429,1382.56277890374,1995.71428571429,1275.96270074253
"222",2021-07-25,3332,2842270,1964,1523184,1511,1405440,110029,3996.28571428571,2583.20079251834,2212.57142857143,1384.34776286252,1949.57142857143,1277.33597506112
"223",2021-07-26,1611,2843881,1233,1524417,490,1405930,110029,3972.14285714286,2584.66495196721,2261.42857142857,1385.46837651892,1879.57142857143,1277.78131219951
"224",2021-07-27,4605,2848486,2960,1527377,1833,1407763,110029,3987.57142857143,2588.85021221678,2348.28571428571,1388.15857637532,1802,1279.44723663761
"225",2021-07-28,4773,2853259,3035,1530412,1924,1409687,110029,4057.14285714286,2593.18815948523,2455.14285714286,1390.91694007943,1763.71428571429,1281.19586654427
"226",2021-07-29,4647,2857906,2768,1533180,2075,1411762,110029,4035.14285714286,2597.41159148952,2499.28571428571,1393.43264048569,1698.28571428571,1283.08173299766
"227",2021-07-30,4418,2862324,2810,1535990,1801,1413563,110029,4036.57142857143,2601.42689654546,2525.85714285714,1395.98651264667,1679.28571428571,1284.71857419408
"228",2021-07-31,4842,2867166,3034,1539024,2009,1415572,110029,4032.57142857143,2605.8275545538,2543.42857142857,1398.74396749948,1663.28571428571,1286.54445646148
"229",2021-08-01,3453,2870619,2007,1541031,1578,1417150,110029,4049.85714285714,2608.9658181025,2549.57142857143,1400.56803206427,1672.85714285714,1287.97862381736
"230",2021-08-02,1953,2872572,1259,1542290,789,1417939,110029,4098.71428571429,2610.74080469694,2553.28571428571,1401.71227585455,1715.57142857143,1288.6957074953
"231",2021-08-03,4907,2877479,3181,1545471,1927,1419866,110029,4141.85714285714,2615.20053803997,2584.85714285714,1404.60333184888,1729,1290.44706395587
"232",2021-08-04,5016,2882495,3302,1548773,1948,1421814,110029,4176.57142857143,2619.75933617501,2623,1407.60435885085,1732.42857142857,1292.2175062938
"233",2021-08-05,5115,2887610,3290,1552063,2042,1423856,110029,4243.42857142857,2624.40811058903,2697.57142857143,1410.59447963719,1727.71428571429,1294.07338065419
"234",2021-08-06,4719,2892329,3075,1555138,1830,1425686,110029,4286.42857142857,2628.69697988712,2735.42857142857,1413.38919739341,1731.85714285714,1295.73657853839
"235",2021-08-07,5516,2897845,3551,1558689,2162,1427848,110029,4382.71428571429,2633.71020367358,2809.28571428571,1416.61652836979,1753.71428571429,1297.70151505512
"236",2021-08-08,3381,2901226,2125,1560814,1393,1429241,110029,4372.42857142857,2636.78302992847,2826.14285714286,1418.54783738832,1727.28571428571,1298.96754491998
"237",2021-08-09,1937,2903163,1202,1562016,809,1430050,110029,4370.14285714286,2638.54347490207,2818,1419.64027665434,1730.14285714286,1299.70280562397
"238",2021-08-10,5067,2908230,3093,1565109,2197,1432247,110029,4393,2643.14862445355,2805.42857142857,1422.45135373402,1768.71428571429,1301.69955193631
"239",2021-08-11,4709,2912939,2921,1568030,1974,1434221,110029,4349.14285714286,2647.42840523862,2751,1425.10610838961,1772.42857142857,1303.49362440811
"240",2021-08-12,4595,2917534,2765,1570795,1994,1436215,110029,4274.85714285714,2651.60457697516,2676,1427.61908224195,1765.57142857143,1305.30587390597
"241",2021-08-13,4514,2922048,2566,1573361,2129,1438344,110029,4245.57142857143,2655.70713175617,2603.28571428571,1429.95119468504,1808.28571428571,1307.24081832971
"242",2021-08-14,5125,2927173,2819,1576180,2401,1440745,110029,4189.71428571429,2660.36499468322,2498.71428571429,1432.51324650774,1842.42857142857,1309.42297030783
"243",2021-08-15,3622,2930795,1860,1578040,1687,1442432,110029,4224.14285714286,2663.6568541021,2460.85714285714,1434.20370993102,1884.42857142857,1310.95620245572
"244",2021-08-16,2319,2933114,1125,1579165,1042,1443474,110029,4278.71428571429,2665.76448027338,2449.85714285714,1435.22616764671,1917.71428571429,1311.90322551327
"245",2021-08-17,5745,2938859,2804,1581969,2605,1446079,110029,4375.57142857143,2670.98583100819,2408.57142857143,1437.77458669987,1976,1314.27078315717
"246",2021-08-18,5981,2944840,2967,1584936,2592,1448671,110029,4557.28571428571,2676.42167065046,2415.14285714286,1440.47114851539,2064.28571428571,1316.62652573412
"247",2021-08-19,5801,2950641,2982,1587918,2359,1451030,110029,4729.57142857143,2681.69391705823,2446.14285714286,1443.18134310046,2116.42857142857,1318.77050595752
"248",2021-08-20,5355,2955996,2605,1590523,2354,1453384,110029,4849.71428571429,2686.56081578493,2451.71428571429,1445.54890074435,2148.57142857143,1320.9099419244
"249",2021-08-21,5888,2961884,2844,1593367,2582,1455966,110029,4958.71428571429,2691.91213225604,2455.28571428571,1448.13367384962,2174.42857142857,1323.25659598833
"250",2021-08-22,3848,2965732,1878,1595245,1757,1457723,110029,4991,2695.40939206936,2457.85714285714,1449.84049659635,2184.42857142857,1324.85344772742
"251",2021-08-23,2293,2968025,1050,1596295,1066,1458789,110029,4987.28571428571,2697.49338810677,2447.14285714286,1450.79479046433,2187.85714285714,1325.82228321624
"252",2021-08-24,5884,2973909,2768,1599063,2751,1461540,110029,5007.14285714286,2702.84106917267,2442,1453.31049087059,2208.71428571429,1328.32253315035
"253",2021-08-25,5886,2979795,2848,1601911,2733,1464273,110029,4993.57142857143,2708.19056794118,2425,1455.89889938107,2228.85714285714,1330.80642376101
"254",2021-08-26,5748,2985543,2718,1604629,2703,1466976,110029,4986,2713.41464522989,2387.28571428571,1458.36915722219,2278,1333.26304883258
"255",2021-08-27,5460,2991003,2613,1607242,2499,1469475,110029,5001,2718.37697334339,2388.42857142857,1460.7439856765,2298.71428571429,1335.53426823837
"256",2021-08-28,6675,2997678,3159,1610401,3058,1472533,110029,5113.42857142857,2724.44355578984,2433.42857142857,1463.61504694217,2366.71428571429,1338.31353552245
"257",2021-08-29,4121,3001799,1957,1612358,1912,1474445,110029,5152.42857142857,2728.18893200883,2444.71428571429,1465.39366894182,2388.85714285714,1340.05125921348
"258",2021-08-30,2561,3004360,1242,1613600,1130,1475575,110029,5190.71428571429,2730.5165001954,2472.14285714286,1466.52246225995,2398,1341.07826118569
"259",2021-08-31,5612,3009972,2495,1616095,2618,1478193,110029,5151.85714285714,2735.61697370693,2433.14285714286,1468.79004626053,2379,1343.45763389652
"260",2021-09-01,5396,3015368,2363,1618458,2469,1480662,110029,5081.85714285714,2740.52113533705,2363.85714285714,1470.93766188914,2341.28571428571,1345.70158776323
"261",2021-09-02,5295,3020663,2565,1621023,2384,1483046,110029,5017.14285714286,2745.33350298558,2342,1473.26886548092,2295.71428571429,1347.86828926919
"262",2021-09-03,4986,3025649,2518,1623541,2110,1485156,110029,4949.42857142857,2749.86503558153,2328.42857142857,1475.55735306147,2240.14285714286,1349.78596551818
"263",2021-09-04,6081,3031730,2996,1626537,2613,1487769,110029,4864.57142857143,2755.39176035409,2305.14285714286,1478.28027156477,2176.57142857143,1352.1607939725
"264",2021-09-05,3709,3035439,1862,1628399,1632,1489401,110029,4805.71428571429,2758.76268983632,2291.57142857143,1479.97255269065,2136.57142857143,1353.64403929873
"265",2021-09-06,2326,3037765,1158,1629557,1002,1490403,110029,4772.14285714286,2760.87667796672,2279.57142857143,1481.02500249934,2118.28571428571,1354.55470830417
"266",2021-09-07,480,3038245,213,1629770,227,1490630,110029,4039,2761.31292659208,1953.57142857143,1481.21858782685,1776.71428571429,1354.76101754992
"267",2021-09-08,5959,3044204,2486,1632256,3151,1493781,110029,4119.42857142857,2766.72877150569,1971.14285714286,1483.4779921657,1874.14285714286,1357.62480800516
"268",2021-09-09,5063,3049267,2336,1634592,2413,1496194,110029,4086.28571428571,2771.33028565196,1938.42857142857,1485.60106880913,1878.28571428571,1359.81786619891
"269",2021-09-10,4541,3053808,2096,1636688,2118,1498312,110029,4022.71428571429,2775.45737941815,1878.14285714286,1487.50602113988,1879.42857142857,1361.74281325832
"270",2021-09-11,5783,3059591,2746,1639434,2699,1501011,110029,3980.14285714286,2780.71326650247,1842.42857142857,1490.00172681748,1891.71428571429,1364.19580292468
"271",2021-09-12,3661,3063252,1691,1641125,1812,1502823,110029,3973.28571428571,2784.04057112216,1818,1491.53859437058,1917.42857142857,1365.84264148543
"272",2021-09-13,2153,3065405,1044,1642169,978,1503801,110029,3948.57142857143,2785.99732797717,1801.71428571429,1492.48743513074,1914,1366.7314980596
"273",2021-09-14,4938,3070343,2214,1644383,2405,1506206,110029,4585.42857142857,2790.48523571059,2087.57142857143,1494.49963191522,2225.14285714286,1368.91728544293
"274",2021-09-15,4707,3075050,2237,1646620,2237,1508443,110029,4406.57142857143,2794.76319879305,2052,1496.53273227967,2094.57142857143,1370.95038580738
"275",2021-09-16,4966,3080016,2274,1648894,2439,1510882,110029,4392.71428571429,2799.27655436294,2043.14285714286,1498.59946014233,2098.28571428571,1373.167074135
"276",2021-09-17,4374,3084390,1992,1650886,2129,1513011,110029,4368.85714285714,2803.25186996156,2028.28571428571,1500.40989193758,2099.85714285714,1375.10201855874
"277",2021-09-18,5528,3089918,2409,1653295,2745,1515756,110029,4332.42857142857,2808.27599996365,1980.14285714286,1502.59931472612,2106.42857142857,1377.59681538503
"278",2021-09-19,3261,3093179,1416,1654711,1708,1517464,110029,4275.28571428571,2811.2397640622,1940.85714285714,1503.88624817094,2091.57142857143,1379.14913341028
"279",2021-09-20,1945,3095124,833,1655544,999,1518463,110029,4245.57142857143,2813.00747984622,1910.71428571429,1504.6433213062,2094.57142857143,1380.05707586182
"280",2021-09-21,4683,3099807,2070,1657614,2246,1520709,110029,4209.14285714286,2817.26363049741,1890.14285714286,1506.52464350308,2071.85714285714,1382.09835588799
"281",2021-09-22,4270,3104077,1845,1659459,2107,1522816,110029,4146.71428571429,2821.14442556053,1834.14285714286,1508.20147415681,2053.28571428571,1384.01330558307
"282",2021-09-23,4319,3108396,2001,1661460,1996,1524812,110029,4054.28571428571,2825.06975433749,1795.14285714286,1510.02008561379,1990,1385.82737278354
"283",2021-09-24,4165,3112561,1690,1663150,1987,1526799,110029,4024.42857142857,2828.85512001381,1752,1511.55604431559,1969.71428571429,1387.63326032228
"284",2021-09-25,5833,3118394,2047,1665197,2502,1529301,110029,4068,2834.15644966327,1700.28571428571,1513.4164629325,1935,1389.90720628198
"285",2021-09-26,4260,3122654,1273,1666470,1626,1530927,110029,4210.71428571429,2838.02815621336,1679.85714285714,1514.57343064101,1923.28571428571,1391.3849985004
"286",2021-09-27,2773,3125427,790,1667260,979,1531906,110029,4329,2840.54840087613,1673.71428571429,1515.29142317026,1920.42857142857,1392.27476392587
"287",2021-09-28,5891,3131318,1915,1669175,1208,1533114,110029,4501.57142857143,2845.90244390115,1651.57142857143,1517.03187341519,1772.14285714286,1393.3726562997
"288",2021-09-29,7818,3139136,1897,1671072,2123,1535237,110029,5008.42857142857,2853.00784338674,1659,1518.75596433667,1774.42857142857,1395.30214761563
"289",2021-09-30,8247,3147383,2027,1673099,2045,1537282,110029,5569.57142857143,2860.50314008125,1662.71428571429,1520.59820592753,1781.42857142857,1397.16074852993
"290",2021-10-01,8352,3155735,1990,1675089,1882,1539164,110029,6167.71428571429,2868.09386616256,1705.57142857143,1522.40682002018,1766.42857142857,1398.87120668187
"291",2021-10-02,8487,3164222,2316,1677405,2422,1541586,110029,6546.85714285714,2875.80728716975,1744,1524.51171963755,1755,1401.07244453735
"292",2021-10-03,4884,3169106,1302,1678707,1423,1543009,110029,6636,2880.24611693281,1748.14285714286,1525.69504403385,1726,1402.36573994129
"293",2021-10-04,2660,3171766,743,1679450,820,1543829,110029,6619.85714285714,2882.66366139836,1741.42857142857,1526.37032055185,1703.28571428571,1403.11099800962
"294",2021-10-05,6899,3178665,1797,1681247,1759,1545588,110029,6763.85714285714,2888.93382653664,1724.57142857143,1528.00352634306,1782,1404.70966745131
"295",2021-10-06,7499,3186164,1781,1683028,1892,1547480,110029,6718.28571428571,2895.74930245663,1708,1529.62219051341,1749,1406.42921411628
"296",2021-10-07,7707,3193871,1827,1684855,1869,1549349,110029,6641.14285714286,2902.7538194476,1679.42857142857,1531.2826618437,1723.85714285714,1408.12785720128
"297",2021-10-08,6637,3200508,1616,1686471,1627,1550976,110029,6396.14285714286,2908.78586554454,1626,1532.75136554908,1687.42857142857,1409.606558271
"298",2021-10-09,8565,3209073,2024,1688495,2105,1553081,110029,6407.28571428571,2916.57017695335,1584.28571428571,1534.59088058603,1642.14285714286,1411.51969026348
"299",2021-10-10,4291,3213364,1213,1689708,1272,1554353,110029,6322.57142857143,2920.47005789383,1571.57142857143,1535.69331721637,1620.57142857143,1412.67574912069
"300",2021-10-11,2504,3215868,682,1690390,745,1555098,110029,6300.28571428571,2922.74582155614,1562.85714285714,1536.31315380491,1609.85714285714,1413.3528433413
"301",2021-10-12,6549,3222417,1687,1692077,1595,1556693,110029,6250.28571428571,2928.69788873842,1547.14285714286,1537.84638595279,1586.42857142857,1414.80246116933
"302",2021-10-13,8102,3230519,1871,1693948,1711,1558404,110029,6336.42857142857,2936.06140199402,1560,1539.5468467404,1560.57142857143,1416.35750574848
"303",2021-10-14,7009,3237528,1851,1695799,1867,1560271,110029,6236.71428571429,2942.43154077561,1563.42857142857,1541.22913050196,1560.28571428571,1418.05433113088
"304",2021-10-15,8067,3245595,1931,1697730,1736,1562007,110029,6441,2949.76324423561,1608.42857142857,1542.98412236774,1575.85714285714,1419.63209699261
"305",2021-10-16,7813,3253408,1906,1699636,1934,1563941,110029,6333.57142857143,2956.86409946469,1591.57142857143,1544.71639295095,1551.42857142857,1421.3898154123
"306",2021-10-17,4167,3257575,1099,1700735,1148,1565089,110029,6315.85714285714,2960.65128284361,1575.28571428571,1545.71522053277,1533.71428571429,1422.43317670796
"307",2021-10-18,2280,3259855,629,1701364,657,1565746,110029,6283.85714285714,2962.72346381409,1567.71428571429,1546.28688800225,1521.14285714286,1423.03029201392
"308",2021-10-19,6732,3266587,1684,1703048,1604,1567350,110029,6310,2968.84185078479,1567.28571428571,1547.81739359623,1522.42857142857,1424.48808950368
"309",2021-10-20,6713,3273300,1525,1704573,1448,1568798,110029,6111.57142857143,2974.94296958075,1517.85714285714,1549.20339183306,1484.85714285714,1425.80410619019
"310",2021-10-21,6525,3279825,1426,1705999,1571,1570369,110029,6042.42857142857,2980.87322433177,1457.14285714286,1550.49941379091,1442.57142857143,1427.23191158695
"311",2021-10-22,7007,3286832,1387,1707386,1477,1571846,110029,5891,2987.24154541076,1379.42857142857,1551.75999054795,1405.57142857143,1428.57428496124
"312",2021-10-23,10405,3297237,1898,1709284,2265,1574111,110029,6261.28571428571,2996.69814321679,1378.28571428571,1553.48499032073,1452.85714285714,1430.63283316217
"313",2021-10-24,6143,3303380,1137,1710421,1373,1575484,110029,6543.57142857143,3002.28121677012,1383.71428571429,1554.51835425206,1485,1431.88068600096
"314",2021-10-25,3627,3307007,612,1711033,784,1576268,110029,6736,3005.57762044552,1381.28571428571,1555.0745712494,1503.14285714286,1432.59322542239
"315",2021-10-26,10225,3317232,1752,1712785,2078,1578346,110029,7235,3014.87062501704,1391,1556.66687873197,1570.85714285714,1434.48181842969
"316",2021-10-27,11438,3328670,1849,1714634,2197,1580543,110029,7910,3025.26606621891,1437.28571428571,1558.34734479092,1677.85714285714,1436.47856474202
"317",2021-10-28,11515,3340185,1888,1716522,2147,1582690,110029,8622.85714285714,3035.73148897109,1503.28571428571,1560.06325605068,1760.14285714286,1438.42986848922
"318",2021-10-29,11568,3351753,1750,1718272,2038,1584728,110029,9274.42857142857,3046.24508084232,1555.14285714286,1561.65374583064,1840.28571428571,1440.2821074444
"319",2021-10-30,11933,3363686,1998,1720270,2379,1587107,110029,9492.71428571429,3057.09040343909,1569.42857142857,1563.46963073372,1856.57142857143,1442.44426469385
"320",2021-10-31,6229,3369915,1166,1721436,1421,1588528,110029,9505,3062.75163820447,1573.57142857143,1564.52935135283,1863.42857142857,1443.73574239519
"321",2021-11-01,3903,3373818,654,1722090,838,1589366,110029,9544.42857142857,3066.29888483945,1579.57142857143,1565.12374010488,1871.14285714286,1444.49735978697
"322",2021-11-02,10646,3384464,1836,1723926,2212,1591578,110029,9604.57142857143,3075.97451580947,1591.57142857143,1566.79239109689,1890.28571428571,1446.50773886884
"323",2021-11-03,10994,3395458,1754,1725680,1965,1593543,110029,9541.14285714286,3085.96642703287,1578,1568.38651628207,1857.14285714286,1448.29363167892
"324",2021-11-04,11124,3406582,1972,1727652,1932,1595475,110029,9485.28571428571,3096.07648892565,1590,1570.17877105127,1826.42857142857,1450.049532396
"325",2021-11-05,12998,3419580,2902,1730554,1987,1597462,110029,9689.57142857143,3107.88973815994,1754.57142857143,1572.81625753211,1819.14285714286,1451.85541993474
"326",2021-11-06,15792,3435372,4362,1734916,2156,1599618,110029,10240.8571428571,3122.24231793436,2092.28571428571,1576.78066691509,1787.28571428571,1453.81490334366
"327",2021-11-07,8876,3444248,3165,1738081,1267,1600885,110029,10619,3130.30928209836,2377.85714285714,1579.65718128857,1765.28571428571,1454.96641794436
"328",2021-11-08,5324,3449572,2206,1740287,715,1601600,110029,10822,3135.14800643467,2599.57142857143,1581.66210726263,1747.71428571429,1455.61624662589
"329",2021-11-09,11843,3461415,3637,1743924,1751,1603351,110029,10993,3145.91153241418,2856.85714285714,1584.96759945105,1681.85714285714,1457.20764525716
"330",2021-11-10,13576,3474991,4163,1748087,1890,1605241,110029,11361.8571428571,3158.25009770152,3201,1588.75114742477,1671.14285714286,1458.92537421952
"331",2021-11-11,13997,3488988,4372,1752459,1828,1607069,110029,11772.2857142857,3170.97128938734,3543.85714285714,1592.72464532078,1656.28571428571,1460.58675440111
"332",2021-11-12,16992,3505980,6967,1759426,1621,1608690,110029,12342.8571428571,3186.41449072517,4124.57142857143,1599.05661234765,1604,1462.06000236301
"333",2021-11-13,22469,3528449,11160,1770586,2134,1610824,110029,13296.7142857143,3206.83547064865,5095.71428571429,1609.19939288733,1600.85714285714,1463.99949104327
"334",2021-11-14,10452,3538901,4369,1774955,1061,1611885,110029,13521.8571428571,3216.33478446591,5267.71428571429,1613.17016422943,1571.42857142857,1464.96378227558
"335",2021-11-15,5508,3544409,2308,1777263,583,1612468,110029,13548.1428571429,3221.34073744195,5282.28571428571,1615.26779303638,1552.57142857143,1465.49364258514
"336",2021-11-16,13002,3557411,3609,1780872,1711,1614179,110029,13713.7142857143,3233.15762208145,5278.28571428571,1618.54783738832,1546.85714285714,1467.04868716429
"337",2021-11-17,14217,3571628,3879,1784751,1749,1615928,110029,13805.2857142857,3246.0787610539,5237.71428571429,1622.07327159203,1526.71428571429,1468.63826809296
"338",2021-11-18,15260,3586888,4752,1789503,1761,1617689,110029,13985.7142857143,3259.94783193522,5292,1626.39213298312,1517.14285714286,1470.23875523726
"339",2021-11-19,14540,3601428,4042,1793545,1655,1619344,110029,13635.4285714286,3273.16252987849,4874.14285714286,1630.0657099492,1522,1471.74290414345
"340",2021-11-20,16233,3617661,4132,1797677,1875,1621219,110029,12744.5714285714,3287.91591307746,3870.14285714286,1633.82108353252,1485,1473.44700033628
"341",2021-11-21,10214,3627875,3621,1801298,1033,1622252,110029,12710.5714285714,3297.19892028465,3763.28571428571,1637.1120341001,1481,1474.38584373211
"342",2021-11-22,5577,3633452,1626,1802924,647,1622899,110029,12720.4285714286,3302.26758400058,3665.85714285714,1638.58982631852,1490.14285714286,1474.97387052504
"343",2021-11-23,14816,3648268,3093,1806017,1814,1624713,110029,12979.5714285714,3315.73312490343,3592.14285714286,1641.4009033982,1504.85714285714,1476.62252678839
"344",2021-11-24,14401,3662669,3240,1809257,1634,1626347,110029,13005.8571428571,3328.82149251561,3500.85714285714,1644.34558161939,1488.42857142857,1478.10758981723
"345",2021-11-25,13320,3675989,3420,1812677,1897,1628244,110029,12728.7142857143,3340.92739186942,3310.57142857143,1647.4538530751,1507.85714285714,1479.83168073871
"346",2021-11-26,119,3676108,33,1812710,31,1628275,110029,10668.5714285714,3341.03554517445,2737.85714285714,1647.48384516809,1275.85714285714,1479.8598551291
"347",2021-11-27,11435,3687543,2376,1815086,2069,1630344,110029,9983.14285714286,3351.42825982241,2487,1649.64327586364,1303.57142857143,1481.74026847467
"348",2021-11-28,8782,3696325,1605,1816691,2525,1632869,110029,9778.57142857143,3359.40979196394,2199,1651.10198220469,1516.71428571429,1484.03511801434
"349",2021-11-29,5635,3701960,902,1817593,1899,1634768,110029,9786.85714285714,3364.53116905543,2095.57142857143,1651.92176607985,1695.57142857143,1485.76102663843
"350",2021-11-30,14941,3716901,2634,1820227,3881,1638649,110029,9804.71428571429,3378.11031637114,2030,1654.31568041153,1990.85714285714,1489.28827854475
"351",2021-12-01,16003,3732904,2869,1823096,4110,1642759,110029,10033.5714285714,3392.65466377046,1977,1656.92317479937,2344.57142857143,1493.02365739941
"352",2021-12-02,17182,3750086,2942,1826038,3759,1646518,110029,10585.2857142857,3408.27054685583,1908.71428571429,1659.59701533232,2610.57142857143,1496.44002944678
"353",2021-12-03,18483,3768569,3017,1829055,5249,1651767,110029,13208.7142857143,3425.06884548619,2335,1662.33901971298,3356,1501.21058993538
"354",2021-12-04,22272,3790841,3299,1832354,7660,1659427,110029,14756.8571428571,3445.31078170301,2466.85714285714,1665.33732016105,4154.71428571429,1508.17239091512
"355",2021-12-05,14387,3805228,2246,1834600,5637,1665064,110029,15557.5714285714,3458.38642539694,2558.42857142857,1667.37860018722,4599.28571428571,1513.29558570922
"356",2021-12-06,6856,3812084,1184,1835784,2355,1667419,110029,15732,3464.6175099292,2598.71428571429,1668.45468012978,4664.42857142857,1515.43593052741
"357",2021-12-07,16557,3828641,2927,1838711,3443,1670862,110029,15962.8571428571,3479.66536095029,2640.57142857143,1671.11488789319,4601.85714285714,1518.56510556308
"358",2021-12-08,17313,3845954,3278,1841989,3354,1674216,110029,16150,3495.40030355634,2699,1674.0941024639,4493.85714285714,1521.6133928328
"359",2021-12-09,17490,3863444,3294,1845283,3839,1678055,110029,16194,3511.29611284298,2749.28571428571,1677.08785865545,4505.28571428571,1525.1024729844
"360",2021-12-10,17390,3880834,3453,1848736,3448,1681503,110029,16037.8571428571,3527.10103699934,2811.57142857143,1680.22612220415,4248,1528.23619227658
"361",2021-12-11,19136,3899970,3621,1852357,3991,1685494,110029,15589.8571428571,3544.49281553045,2857.57142857143,1683.51707277172,3723.85714285714,1531.86341782621
"362",2021-12-12,11002,3910972,2264,1854621,3348,1688842,110029,15106.2857142857,3554.49199756428,2860.14285714286,1685.57471212135,3396.85714285714,1534.90625198811
"363",2021-12-13,6764,3917736,1359,1855980,1592,1690434,110029,15093.1428571429,3560.63946777668,2885.14285714286,1686.80984104191,3287.85714285714,1536.35314326223
"364",2021-12-14,15111,3932847,2898,1858878,2669,1693103,110029,14886.5714285714,3574.37311981387,2881,1689.44369211753,3177.28571428571,1538.77886738951
"365",2021-12-15,15281,3948128,3110,1861988,2781,1695884,110029,14596.2857142857,3588.26127657254,2857,1692.27021966936,3095.42857142857,1541.3063828627
"366",2021-12-16,16288,3964416,3210,1865198,2911,1698795,110029,14424.5714285714,3603.06464659317,2845,1695.18763235147,2962.85714285714,1543.95204900526
"367",2021-12-17,16046,3980462,3397,1868595,2012,1700807,110029,14232.5714285714,3617.64807459852,2837,1698.27500022721,2757.71428571429,1545.78065782657
"368",2021-12-18,17287,3997749,3513,1872108,2746,1703553,110029,13968.4285714286,3633.35938707068,2821.57142857143,1701.46779485408,2579.85714285714,1548.27636350417
"369",2021-12-19,10850,4008599,2691,1874799,1735,1705288,110029,13946.7142857143,3643.22042370648,2882.57142857143,1703.91351371002,2349.42857142857,1549.85322051459
"370",2021-12-20,7377,4015976,1847,1876646,913,1706201,110029,14034.2857142857,3649.92501976752,2952.28571428571,1705.59216206636,2252.42857142857,1550.68300175408
"371",2021-12-21,15828,4031804,3466,1880112,2328,1708529,110029,14136.7142857143,3664.31031818884,3033.42857142857,1708.742240682,2203.71428571429,1552.79880758709
"372",2021-12-22,17048,4048852,3874,1883986,2276,1710805,110029,14389.1428571429,3679.80441519963,3142.57142857143,1712.2631306292,2131.57142857143,1554.86735315235
"373",2021-12-23,16815,4065667,4168,1888154,2338,1713143,110029,14464.4285714286,3695.08674985686,3279.42857142857,1716.05122285943,2049.71428571429,1556.99224749839
"374",2021-12-24,14655,4080322,3800,1891954,2198,1715341,110029,14265.7142857143,3708.40596569995,3337,1719.50485781021,2076.28571428571,1558.98990266203
"375",2021-12-25,3176,4083498,896,1892850,482,1715823,110029,12249.8571428571,3711.29247743777,2963.14285714286,1720.31918857756,1752.85714285714,1559.42796898999
"376",2021-12-26,65,4083563,23,1892873,7,1715830,110029,10709.1428571429,3711.35155277245,2582,1720.34009215752,1506,1559.43433094911
"377",2021-12-27,4298,4087861,1097,1893970,690,1716520,110029,10269.2857142857,3715.25779567205,2474.85714285714,1721.33710203674,1474.14285714286,1560.06143834807
"378",2021-12-28,13868,4101729,3850,1897820,2278,1718798,110029,9989.28571428571,3727.86174553981,2529.71428571429,1724.83617955266,1467,1562.13180161594
"379",2021-12-29,14332,4116061,4303,1902123,2342,1721140,110029,9601.28571428571,3740.88740241209,2591,1728.74696670878,1476.42857142857,1564.26033136719
"380",2021-12-30,15190,4131251,4666,1906789,2232,1723372,110029,9369.14285714286,3754.69285370221,2662.14285714286,1732.98766688782,1461.28571428571,1566.28888747512
"381",2021-12-31,14304,4145555,4759,1911548,2117,1725489,110029,9319,3767.69306273801,2799.14285714286,1737.31289023803,1449.71428571429,1568.21292568323
"382",2022-01-01,4527,4150082,1477,1913025,827,1726316,110029,9512,3771.80743258595,2882.14285714286,1738.65526361232,1499,1568.96454571068
"383",2022-01-02,300,4150382,144,1913169,53,1726369,110029,9545.57142857143,3772.08008797681,2899.42857142857,1738.78613819993,1505.57142857143,1569.01271482973
"384",2022-01-03,3731,4154113,1141,1914310,691,1727060,110029,9464.57142857143,3775.4710121877,2905.71428571429,1739.82313753647,1505.71428571429,1569.64073107999
"385",2022-01-04,11954,4166067,4377,1918687,2147,1729207,110029,9191.14285714286,3786.33542066183,2981,1743.80117968899,1487,1571.59203482718
"386",2022-01-05,13108,4179175,4828,1923515,2203,1731410,110029,9016.28571428571,3798.24864353943,3056,1748.18911377909,1467.14285714286,1573.59423424733
"387",2022-01-06,12710,4191885,4682,1928197,2084,1733494,110029,8662,3809.80014359851,3058.28571428571,1752.44435557898,1446,1575.48828036245
"388",2022-01-07,6697,4198582,2516,1930713,1214,1734708,110029,7575.28571428571,3815.88672077361,2737.85714285714,1754.73102545692,1317,1576.5916258441
